....................
....................
..............R.....
...........SS.......
..........####......
...S................
...###..............
..........RRRR......
..........SS........
.........#####......
RR..................
####................
....................
P................RRR
####################
