....................
....................
..............R.....
....................
..........####......
....................
...###..............
..........RRRR......
....................
.........#####......
RR..................
####................
....................
P................RRR
####################
