....................
....................
...........S........
.......######.......
..C..............C..
####.............###
....................
....................
....................
....................
.C.F............S.C.
####............####
.....C.C.C.C.C......
....................
####################
